ğŸ“Œ ESTADO Y NAVEGACIÃ“N
    Comando	Para quÃ© sirve
        git status	Ver en quÃ© branch estÃ¡s y si hay cambios pendientes
        git branch	Listar ramas locales y ver cuÃ¡l estÃ¡ activa
        git branch -r	Ver ramas remotas (las que estÃ¡n en GitHub)
        git remote -v	Ver URL del repositorio remoto conectado
ğŸ“¦ ğŸ’¾ COMMITS Y CAMBIOS
    Comando	Para quÃ© sirve
        git add .	Agrega todos los archivos modificados al "staging area"
        git commit -m "Mensaje"	Crea un commit con mensaje
        git log --oneline -n 10	Ver los Ãºltimos 10 commits breves
        git diff	Ver cambios pendientes no comiteados
ğŸš€ ğŸŒ PUSH & PULL
    Comando	Para quÃ© sirve
        git push origin main	Sube tus cambios al branch main remoto
        git pull origin main	Baja los Ãºltimos cambios de main remoto
        git fetch	Actualiza referencias remotas sin hacer merge automÃ¡tico
        git clone URL .	Clona repo en carpeta actual
ğŸŒ¿ ğŸŒ± RAMAS Y MERGE
    Comando	Para quÃ© sirve
        git checkout -b nombre	Crea y cambia a una nueva rama
        git checkout main	Cambia de rama (ej. a main)
        git merge rama-b	Trae los cambios de rama-b a la rama actual
        git branch -d nombre	Borra rama local
        git push origin --delete nombre	Borra rama remota
ğŸ·ï¸ ğŸ TAGS Y RELEASES
    Comando	Para quÃ© sirve
        git tag v1.0	Crea un tag en el commit actual
        git push origin v1.0	Sube el tag a GitHub
ğŸ§¼ ğŸ’£ REPARACIONES (cuando algo truena)
    Comando	Para quÃ© sirve
        git stash	Guarda cambios sin commit para no perderlos
        git stash pop	Recupera los cambios guardados
        git reset --hard	âš ï¸ Revierte todo al Ãºltimo commit (pierdes cambios no guardados)
        git clean -fd	âš ï¸ Borra archivos y carpetas no versionados


----------------
  git add .
  git commit -m " "
  git push origin main
  git tag ""
  git push origin ""
  